00-00-00-50-00.gat#00-00-00-50-00.wlk#
00-00-01-50-00.gat#00-00-01-50-00.wlk#
00-00-02-50-00.gat#00-00-02-50-00.wlk#
00-00-03-50-00.gat#00-00-03-50-00.wlk#
00-00-04-50-00.gat#00-00-04-50-00.wlk#
00-00-05-50-00.gat#00-00-05-50-00.wlk#
00-00-06-50-00.gat#00-00-06-50-00.wlk#
00-00-07-50-00.gat#00-00-07-50-00.wlk#
00-00-08-50-00.gat#00-00-08-50-00.wlk#
00-00-09-50-00.gat#00-00-09-50-00.wlk#
00-01-00-50-00.gat#00-01-00-50-00.wlk#
00-01-01-50-00.gat#00-01-01-50-00.wlk#
00-01-02-50-00.gat#00-01-02-50-00.wlk#
00-01-03-50-00.gat#00-01-03-50-00.wlk#
00-01-04-50-00.gat#00-01-04-50-00.wlk#
00-01-05-50-00.gat#00-01-05-50-00.wlk#
00-01-06-50-00.gat#00-01-06-50-00.wlk#
00-01-07-50-00.gat#00-01-07-50-00.wlk#
00-01-08-50-00.gat#00-01-08-50-00.wlk#
00-01-09-50-00.gat#00-01-09-50-00.wlk#
00-02-00-50-00.gat#00-02-00-50-00.wlk#
00-02-01-50-00.gat#00-02-01-50-00.wlk#
00-02-02-50-00.gat#00-02-02-50-00.wlk#
00-02-03-50-00.gat#00-02-03-50-00.wlk#
00-02-04-50-00.gat#00-02-04-50-00.wlk#
00-02-05-50-00.gat#00-02-05-50-00.wlk#
00-02-06-50-00.gat#00-02-06-50-00.wlk#
00-02-07-50-00.gat#00-02-07-50-00.wlk#
00-02-08-50-00.gat#00-02-08-50-00.wlk#
00-02-09-50-00.gat#00-02-09-50-00.wlk#
00-03-00-50-00.gat#00-03-00-50-00.wlk#
00-03-01-50-00.gat#00-03-01-50-00.wlk#
00-03-02-50-00.gat#00-03-02-50-00.wlk#
00-03-03-50-00.gat#00-03-03-50-00.wlk#
00-03-04-50-00.gat#00-03-04-50-00.wlk#
00-03-05-50-00.gat#00-03-05-50-00.wlk#
00-03-06-50-00.gat#00-03-06-50-00.wlk#
00-03-07-50-00.gat#00-03-07-50-00.wlk#
00-03-08-50-00.gat#00-03-08-50-00.wlk#
00-03-09-50-00.gat#00-03-09-50-00.wlk#
00-04-00-50-00.gat#00-04-00-50-00.wlk#
00-04-01-50-00.gat#00-04-01-50-00.wlk#
00-04-02-50-00.gat#00-04-02-50-00.wlk#
00-04-03-50-00.gat#00-04-03-50-00.wlk#
00-04-04-50-00.gat#00-04-04-50-00.wlk#
00-04-05-50-00.gat#00-04-05-50-00.wlk#
00-04-06-50-00.gat#00-04-06-50-00.wlk#
00-04-07-50-00.gat#00-04-07-50-00.wlk#
00-04-08-50-00.gat#00-04-08-50-00.wlk#
00-04-09-50-00.gat#00-04-09-50-00.wlk#
00-05-00-50-00.gat#00-05-00-50-00.wlk#
00-05-01-50-00.gat#00-05-01-50-00.wlk#
00-05-02-50-00.gat#00-05-02-50-00.wlk#
00-05-03-50-00.gat#00-05-03-50-00.wlk#
00-05-04-50-00.gat#00-05-04-50-00.wlk#
00-05-05-50-00.gat#00-05-05-50-00.wlk#
00-05-06-50-00.gat#00-05-06-50-00.wlk#
00-05-07-50-00.gat#00-05-07-50-00.wlk#
00-05-08-50-00.gat#00-05-08-50-00.wlk#
00-05-09-50-00.gat#00-05-09-50-00.wlk#
00-06-00-50-00.gat#00-06-00-50-00.wlk#
00-06-01-50-00.gat#00-06-01-50-00.wlk#
00-06-02-50-00.gat#00-06-02-50-00.wlk#
00-06-03-50-00.gat#00-06-03-50-00.wlk#
00-06-04-50-00.gat#00-06-04-50-00.wlk#
00-06-05-50-00.gat#00-06-05-50-00.wlk#
00-06-06-50-00.gat#00-06-06-50-00.wlk#
00-06-07-50-00.gat#00-06-07-50-00.wlk#
00-06-08-50-00.gat#00-06-08-50-00.wlk#
00-06-09-50-00.gat#00-06-09-50-00.wlk#
00-07-00-50-00.gat#00-07-00-50-00.wlk#
00-07-01-50-00.gat#00-07-01-50-00.wlk#
00-07-02-50-00.gat#00-07-02-50-00.wlk#
00-07-03-50-00.gat#00-07-03-50-00.wlk#
00-07-04-50-00.gat#00-07-04-50-00.wlk#
00-07-05-50-00.gat#00-07-05-50-00.wlk#
00-07-06-50-00.gat#00-07-06-50-00.wlk#
00-07-07-50-00.gat#00-07-07-50-00.wlk#
00-07-08-50-00.gat#00-07-08-50-00.wlk#
00-07-09-50-00.gat#00-07-09-50-00.wlk#
00-08-00-50-00.gat#00-08-00-50-00.wlk#
00-08-01-50-00.gat#00-08-01-50-00.wlk#
00-08-02-50-00.gat#00-08-02-50-00.wlk#
00-08-03-50-00.gat#00-08-03-50-00.wlk#
00-08-04-50-00.gat#00-08-04-50-00.wlk#
00-08-05-50-00.gat#00-08-05-50-00.wlk#
00-08-06-50-00.gat#00-08-06-50-00.wlk#
00-08-07-50-00.gat#00-08-07-50-00.wlk#
00-08-08-50-00.gat#00-08-08-50-00.wlk#
00-08-09-50-00.gat#00-08-09-50-00.wlk#
00-09-00-50-00.gat#00-09-00-50-00.wlk#
00-09-01-50-00.gat#00-09-01-50-00.wlk#
00-09-02-50-00.gat#00-09-02-50-00.wlk#
00-09-03-50-00.gat#00-09-03-50-00.wlk#
00-09-04-50-00.gat#00-09-04-50-00.wlk#
00-09-05-50-00.gat#00-09-05-50-00.wlk#
00-09-06-50-00.gat#00-09-06-50-00.wlk#
00-09-07-50-00.gat#00-09-07-50-00.wlk#
00-09-08-50-00.gat#00-09-08-50-00.wlk#
00-09-09-50-00.gat#00-09-09-50-00.wlk#
botcheck.gat#botcheck.wlk#
